O O O O O O O O O O O O O O O O O O O O O O O O O O O O O O O O O O O O O O O . 
O                           J J J J J J J                                     O 
O                           J J J J J J J                             S S     O 
O                                                                         S   O 
O                         D D D D D D D D D                                   O 
O       A A A A A A       D D D D D D D D D                     A   S         O 
O                         D D D D D D A D D                                   O 
O B B                     D D D D A D D D A         A A                   B B O 
O B B                     D D D D D D D D D   A A A A A A A A A A         B B O 
O B B                     D D D D A D D D D                               B B O 
O B B                     D D D D D D D D D                               B B O 
O A A A A A A A A A A     D D D D D D D D D                               B B O 
O A B                     D D D D A D D D D                               B B O 
O A                                                                           O 
O A A A A A A A A A A A           A A A       A A A A A A A A A A             O 
O                                                                             O 
O     S   S                                                                   O 
O   S                                                                         O 
O   S                                                                 T T T T O 
O O O O O O O O O O O O O O O O O O O O O O O O O O O O O O O O O O O O O O O O 
