O O O O O O O O O O O O O O O O O O O O O O O O O O O O O O O O O O O O O O O O 
O                           J J J J J J J                                     O 
O                           J J J J J J J                             S       O 
O                                                               S             O 
O                         D D D D D D D D D                   S               O 
O                         D D A D D D D D D                         S         O 
O                         D D D D A D D D D                                   O 
O B B                     D D D D D D D D D                               B B O 
O B B                     D D D D D D D D D                               B B O 
O B B                     D D D D D D D D D                               B B O 
O B B                     D D D D D D D D D                               B B O 
O B B                     D D D D D D D D D                               B B O 
O B B                     D D D D D D D D D                               B B O 
O                                                                             O 
O                                                                             O 
O S                                                                           O 
O                                                                             O 
O   S   S                                                                     O 
O S                                                                   T T T T O 
O O O O O O O O O O O O O O O O O O O O O O O O O O O O O O O O O O O O O O O O 
